привет=hello
мир=world
мама=mother
папа=dad
работа=job
практика=practice
первый=first
телефон=telephone
фонарик=flashlight
программирование=programming
логика=logics
письмо=letter
собака=dog
кошка=cat
яйцо=egg
семья=family
пар=steam
ложка=spoon
вилка=fork
стол=table
стул=chair
самолёт=airplane
вертолёт=helicopter
вентилятор=fan
жалюзи=blinds
подушка=pillow
бутылка=bottle
аэрозоль=aerosol
принтер=printer
ручка=pen
пакет=plastic_bag
флешка=flash_drive
машина=car
очки=glasses
блокнот=notebook
статуэтка=statuette
адекалон=adecalon
скакалка=skipping_rope
сумка=bag
книга=book
карты=cards
рамка=frame
зал=hall
аквариум=aquarium
жвачка=gum
обувь=shoes
обои=wallpaper
часы=watch
игрушка=toy
плед=plaid
ковер=carpet
полка=shelf
дым=smoke
сигарета=cigarette
с=with
ментол=menthol
игра=game
провод=the_wire
бумага=paper
тарелка=plate
клавиатура=keyboard
мышь=mouse
монитор=monitor
спрей=spray
пьяница=drunkard
мужчина=man
женщина=woman
ребенок=child
икона=icon
головоломка=puzzle
еда=food
зажигалка=lighter
микрофон=microphone
компьютер=computer
ножницы=scissors
диск=disk
подставка=stand
ластик=eraser
карандаш=pencil
зарядка=charger
линейка=ruler
точилка=pencil_sharpener
сообщение=message
общение=communication
вера=faith
убеждение=belief
зависимость=dependence
отложение=deposition
любовь=love
подоконник=windowsill
камера=camera
батарея=battery
штанга=barbell
розетка=socket
стена=wall
крепление=fastening
нога=leg
труба=pipe
крыса=rat
яблоко=apple
солнце=sun
окно=window
вода=water
музыка=music
ночь=night
друг=friend
цветок=flower
звезда=star
рыба=fish
город=city
утро=morning
парк=park
учитель=teacher
школа=school
луна=moon
земля=earth
глаз=eye
рука=hand
фото=photo
гиря=weight